入山杏奈	Iriyama Anna	AKB48 Team A
大家志津香	Oya Shizuka	AKB48 Team A
大和田南那	Owada Nana	AKB48 Team A
小笠原茉由	Ogasawara Mayu	AKB48 Team A
小嶋菜月	Kojima Natsuki	AKB48 Team A
小嶋陽菜	Kojima Haruna	AKB48 Team A
佐々木優佳里	Sasaki Yukari	AKB48 Team A
島崎遥香	Shimazaki Haruka	AKB48 Team A
白間美瑠	Shiroma Miru	AKB48 Team A / NMB48 Team M
田北香世子	Takita Kayoko	AKB48 Team A
谷口めぐ	Taniguchi Megu	AKB48 Team A
中西智代梨	Nakanishi Chiyori	AKB48 Team A
中村麻里子	Nakamura Mariko	AKB48 Team A
樋渡結依	Hiwatashi Yui	AKB48 Team A
宮崎美穂	Miyazaki Miho	AKB48 Team A
宮脇咲良	Miyawaki Sakura	AKB48 Team A / HKT48 Team K IV
山田菜々美	Yamada Nanami	AKB48 Team A / AKB48 Team 8
横山由依	Yokoyama Yui	AKB48 Team A
相笠萌	Aigasa Moe	AKB48 Team K
阿部マリア	Abe Maria	AKB48 Team K
市川愛美	Ichikawa Manami	AKB48 Team K
兒玉遥	Kodama Haruka	AKB48 Team K / HKT48 Team H
篠崎彩奈	Shinozaki Ayana	AKB48 Team K
島田晴香	Shimada Haruka	AKB48 Team K
下口ひなな	Shimoguchi Hinana	AKB48 Team K
鈴木まりや	Suzuki Mariya	AKB48 Team K
田野優花	Tano Yuuka	AKB48 Team K
中田ちさと	Nakata Chisato	AKB48 Team K
中野郁海	Nakano Ikumi	AKB48 Team K / AKB48 Team 8
藤田奈那	Fujita Nana	AKB48 Team K
峯岸みなみ	Minegishi Minami	AKB48 Team K
向井地美音	Mukaichi Mion	AKB48 Team K
武藤十夢	Mutou Tomu	AKB48 Team K
茂木忍	Mogi Shinobu	AKB48 Team K
湯本亜美	Yumoto Ami	AKB48 Team K
野村奈央	Nomura Nao	Team K Understudy
久保怜音	Kubo Satone	Team K Understudy
梅田綾乃	Umeta Ayano	AKB48 Team B
大島涼花	Oshima Ryoka	AKB48 Team B
柏木由紀	Kashiwagi Yuki	AKB48 Team B /NGT48
加藤玲奈	Kato Rena	AKB48 Team B
木﨑ゆりあ	Kizaki Yuria	AKB48 Team B
後藤萌咲	Goto Moe	AKB48 Team B
坂口渚沙	Sakaguchi Nagisa	AKB48 Team B / AKB48 Team 8
竹内美宥	Takeuchi Miyu	AKB48 Team B
達家真姫宝	Tatsuya Makiho	AKB48 Team B
田名部生来	Tanabe Miku	AKB48 Team B
福岡聖菜	Fukuoka Seina	AKB48 Team B
馬嘉伶	Ma Chia-Ling	AKB48 Team B
矢吹奈子	Yabuki Nako	AKB48 Team B / HKT48 Team H
横島亜衿	Yokoshima Aeri	AKB48 Team B
渡辺麻友	Watanabe Mayu	AKB48 Team B
高橋希良	Takahashi Kira	Team B Understudy
西川怜	Nishikawa Rei	Team B Understudy
山邊歩夢	Yamabe Ayu	Team B Understudy
飯野雅	Iino Miyabi	AKB48 Team 4
伊豆田莉奈	Izuta Rina	AKB48 Team 4
岩立沙穂	Iwatate Saho	AKB48 Team 4
大川莉央	Okawa Rio	AKB48 Team 4
大森美優	Omori Miyuu	AKB48 Team 4
岡田彩花	Okada Ayaka	AKB48 Team 4
岡田奈々	Okada Nana	AKB48 Team 4
川本紗矢	Kawamoto Saya	AKB48 Team 4
北川綾巴	Kitagawa Ryoha	AKB48 Team 4 / SKE48 Team S
北澤早紀	Kitazawa Saki	AKB48 Team 4
小嶋真子	Kojima Mako	AKB48 Team 4
込山榛香	Komiyama Haruka	AKB48 Team 4
佐藤妃星	Sato Kiara	AKB48 Team 4
渋谷凪咲	Shibuya Nagisa	AKB48 Team 4 / NMB48 Team B II
高橋朱里	Takahashi Juri	AKB48 Team 4
朝長美桜	Tomonaga Mio	AKB48 Team 4 / HKT48 Team K IV
西野未姫	Nishino Miki	AKB48 Team 4
野澤玲奈	Nozawa Rena	AKB48 Team 4
村山彩希	Murayama Yuiri	AKB48 Team 4
千葉恵里	Chiba Erii	Team 4 Understudy
坂口渚沙	Sakaguchi Nagisa	AKB48 Team B / AKB48 Team 8
横山結衣	Yokoyama Yui	AKB48 Team 8
谷川聖	Tanikawa Hijiri	AKB48 Team 8
佐藤七海	Sato Nanami	AKB48 Team 8
早坂つむぎ	Hayasaka Tsumugi	AKB48 Team 8
佐藤朱	Sato Akari	AKB48 Team 8
舞木香純	Mougi Kasumi	AKB48 Team 8
岡部麟	Okabe Rin	AKB48 Team 8
本田仁美	Honda Hitomi	AKB48 Team 8
清水麻璃亜	Shimizu Maria	AKB48 Team 8
髙橋彩音	Takahashi Ayane	AKB48 Team 8
吉川七瀬	Yoshikawa Nanase	AKB48 Team 8
小栗有以	Oguri Yui	AKB48 Team 8
小田えりな	Oda Erina	AKB48 Team 8
佐藤栞	Sato Shiori	AKB48 Team 8
左伴彩佳	Hidaritomo Ayaka	AKB48 Team 8
歌田初夏	Utada Hatsuka	AKB48 Team 8
横道侑里	Yokomichi Yuri	AKB48 Team 8
服部有菜	Hattori Yuna	AKB48 Team 8
野田陽菜乃	Noda Hinano	AKB48 Team 8
橋本陽菜	Hashimoto Haruna	AKB48 Team 8
平野ひかる	Hirano Hikaru	AKB48 Team 8
長久玲奈	Cho Kurena	AKB48 Team 8
髙橋彩香	Takahashi Sayaka	AKB48 Team 8
永野芹佳	Nagano Serika	AKB48 Team 8
太田奈緒	Ota Nao	AKB48 Team 8
山田菜々美	Yamada Nanami	AKB48 Team A / AKB48 Team 8
山本瑠香	Yamamoto Ruka	AKB48 Team 8
大西桃香	Onishi Momoka	AKB48 Team 8
濵咲友菜	Hama Sayuna	AKB48 Team 8
中野郁海	Nakano Ikumi	AKB48 Team K / AKB48 Team 8
阿部芽唯	Abe Mei	AKB48 Team 8
人見古都音	Hitomi Kotone	AKB48 Team 8
谷優里	Tani Yuri	AKB48 Team 8
下尾みう	Shitao Miu	AKB48 Team 8
濵松里緒菜	Hamamatsu Riona	AKB48 Team 8
行天優莉奈	Gyoten Yurina	AKB48 Team 8
高岡薫	Takaoka Kaoru	AKB48 Team 8
廣瀬なつき	Hirose Natsuki	AKB48 Team 8
吉田華恋	Yoshida Karen	AKB48 Team 8
福地礼奈	Fukuchi Rena	AKB48 Team 8
寺田美咲	Terada Misaki	AKB48 Team 8
倉野尾成美	Kuranoo Narumi	AKB48 Team 8
吉野未優	Yoshino Miyu	AKB48 Team 8
谷口もか	Yaguchi Moka	AKB48 Team 8
下青木香鈴	Shimoaoki Karin	AKB48 Team 8
宮里莉羅	Miyazato Rira	AKB48 Team 8
青木詩織	Aoki Shiori	SKE48 Team KII
荒井優希	Arai Yuki	SKE48 Team KII
石田安奈	Ishida Anna	SKE48 Team KII
内山命	Uchiyama Mikoto	SKE48 Team KII
江籠裕奈	Ego Yuna	SKE48 Team KII
太田彩夏	Ota Ayaka	SKE48 Team KII
大場美奈	Oba Mina	SKE48 Team KII
小畑優奈	Obata Yuna	SKE48 Team KII
北野瑠華	Kitano Ruka	SKE48 Team KII
白井琴望	Shirai Kotono	SKE48 Team KII
惣田紗莉渚	Soda Sarina	SKE48 Team KII
高木由麻奈	Takagi Yumana	SKE48 Team KII
髙塚夏生	Takatsuka Natsuki	SKE48 Team KII
高柳明音	Takayanagi Akane	SKE48 Team KII
竹内彩姫	Takeuchi Saki	SKE48 Team KII
日高優月	Hidaka Yuzuki	SKE48 Team KII
古畑奈和	Furuhata Nao	SKE48 Team KII
松村香織	Matsumura Kaori	SKE48 Team KII
水野愛理	Mizuno Airi	SKE48 Team KII
相川暖花	Aikawa Honoka	SKE48 Team Kenkyusei
片岡成美	Kataoka Narumi	SKE48 Team Kenkyusei
川崎成美	Kawasaki Narumi	SKE48 Team Kenkyusei
和田愛菜	Wada Aina	SKE48 Team Kenkyusei
渥美彩羽	Atsumi Ayaha	SKE48 Team Kenkyusei
石川咲姫	Ishikawa Saki	SKE48 Team Kenkyusei
石黒友月	Ishiguro Yuzuki	SKE48 Team Kenkyusei
井上瑠夏	Inoue Ruka	SKE48 Team Kenkyusei
大芝りんか	Oshiba Rinka	SKE48 Team Kenkyusei
岡田美紅	Okada Miku	SKE48 Team Kenkyusei
川合杏奈	Kawai Anna	SKE48 Team Kenkyusei
北川愛乃	Kitagawa Yoshino	SKE48 Team Kenkyusei
倉島杏実	Kurashima Ami	SKE48 Team Kenkyusei
小林佳乃	Kobayashi Kano	SKE48 Team Kenkyusei
坂本真凛	Sakamoto Marin	SKE48 Team Kenkyusei
佐藤佳穂	Sato Kaho	SKE48 Team Kenkyusei
白雪希明	Shirayuki Kohaku	SKE48 Team Kenkyusei
仲村和泉	Nakamura Izumi	SKE48 Team Kenkyusei
野々垣美希	Nonogaki Miki	SKE48 Team Kenkyusei
野村実代	Nomura Miyo	SKE48 Team Kenkyusei
深井ねがい	Fukai Negai	SKE48 Team Kenkyusei
森平莉子	Morihira Riko	SKE48 Team Kenkyusei
矢作有紀奈	Yahagi Yukina	SKE48 Team Kenkyusei
浅井裕華	Asai Yuka	SKE48 Team E
井田玲音名	Ida Reona	SKE48 Team E
市野成美	Ichino Narumi	SKE48 Team E
鎌田菜月	Kamata Natsuki	SKE48 Team E
木本花音	Kimoto Kanon	SKE48 Team E
熊崎晴香	Kumazaki Haruka	SKE48 Team E
後藤楽々	Goto Rara	SKE48 Team E
斉藤真木子	Saito Makiko	SKE48 Team E
酒井萌衣	Sakai Mei	SKE48 Team E
佐藤すみれ	Sato Sumire	SKE48 Team E
末永桜花	Suenaga Oka	SKE48 Team E
菅原茉椰	Sugawara Maya	SKE48 Team E
須田亜香里	Suda Akari	SKE48 Team E
髙寺沙菜	Takatera Sana	SKE48 Team E
髙畑結希	Takahata Yuki	SKE48 Team E
谷真理佳	Tani Marika	SKE48 Team E
福士奈央	Fukushi Nao	SKE48 Team E
東李苑	Azuma Rion	SKE48 Team S
一色嶺奈	Isshiki Rena	SKE48 Team S
犬塚あさな	Inuzuka Asana	SKE48 Team S
大矢真那	Oya Masana	SKE48 Team S
上村亜柚香	Kamimura Ayuka	SKE48 Team S
北川綾巴	Kitagawa Ryoha	SKE48 Team S / AKB48 Team 4
後藤理沙子	Goto Risako	SKE48 Team S
杉山愛佳	Sugiyama Aika	SKE48 Team S
竹内舞	Takeuchi Mai	SKE48 Team S
都築里佳	Tsuzuki Rika	SKE48 Team S
野口由芽	Noguchi Yume	SKE48 Team S
野島樺乃	Nojima Kano	SKE48 Team S
二村春香	Futamura Haruka	SKE48 Team S
町音葉	Machi Otoha	SKE48 Team S
松井珠理奈	Matsui Jurina	SKE48 Team S
松本慈子	Matsumoto Chikako	SKE48 Team S
矢方美紀	Yakata Miki	SKE48 Team S
山内鈴蘭	Yamauchi Suzuran	SKE48 Team S
山田樹奈	Yamada Juna	SKE48 Team S
明石奈津子	Akashi Natsuko	NMB48 Team N
石田優美	Ishida Yuumi	NMB48 Team N
太田夢莉	Ota Yuuri	NMB48 Team N
加藤夕夏	Kato Yuuka	NMB48 Team N
古賀成美	Koga Narumi	NMB48 Team N
城恵理子	Jo Eriko	NMB48 Team N
上西恵	Jonishi Kei	NMB48 Team N
須藤凜々花	Suto Ririka	NMB48 Team N
西澤瑠莉奈	Nishizawa Rurina	NMB48 Team N
山尾梨奈	Yamao Rina	NMB48 Team N
山口夕輝	Yamaguchi Yuuki	NMB48 Team N
山本彩	Yamamoto Sayaka	NMB48 Team N
吉田朱里	Yoshida Akari	NMB48 Team N
東由樹	Azuma Yuki	NMB48 Team M
石塚朱莉	Ishizuka Akari	NMB48 Team M
植村梓	Uemura Azusa	NMB48 Team M
鵜野みずき	Uno Mizuki	NMB48 Team M
沖田彩華	Okita Ayaka	NMB48 Team M
川上礼奈	Kawakami Rena	NMB48 Team M
木下百花	Kinoshita Momoka	NMB48 Team M
久代梨奈	Kushiro Rina	NMB48 Team M
白間美瑠	Shiroma Miru	NMB48 Team M / AKB48 TeamA
武井紗良	Takei Sara	NMB48 Team M
谷川愛梨	Tanigawa Airi	NMB48 Team M
中野麗来	Nakano Reina	NMB48 Team M
藤江れいな	Fujie Reina	NMB48 Team M
堀詩音	Hori Shion	NMB48 Team M
松村芽久未	Matsumura Megumi	NMB48 Team M
三田麻央	Mita Mao	NMB48 Team M
村瀬紗英	Murase Sae	NMB48 Team M
森田彩花	Morita Ayaka	NMB48 Team M
矢倉楓子	Yagura Fuuko	NMB48 Team M
井尻晏菜	Ijiri Anna	NMB48 Team BII
磯佳奈江	Iso Kanae	NMB48 Team BII
市川美織	Ichikawa Miori	NMB48 Team BII
大段舞依	Odan Mai	NMB48 Team BII
上枝恵美加	Kamieda Emika	NMB48 Team BII
川上千尋	Kawakami Chihiro	NMB48 Team BII
日下このみ	Kusaka Konomi	NMB48 Team BII
黒川葉月	Kurokawa Hazuki	NMB48 Team BII
渋谷凪咲	Shibuya Nagisa	NMB48 Team BII / AKB48 Team4
内木志	Naiki Kokoro	NMB48 Team BII
林萌々香	Hayashi Momoka	NMB48 Team BII
薮下柊	Yabushita Shu	NMB48 Team BII
西仲七海	Nishinaka Nanami	NMB48 Team Kenkyusei
本郷柚巴	Hongo Yuzuha	NMB48 Team Kenkyusei
安藤愛璃菜	Ando Erina	NMB48 Team Kenkyusei
村中有基	Muranaka Yuki	NMB48 Team Kenkyusei
安田桃寧	Yasuda Momone	NMB48 Team Kenkyusei
岩田桃夏	Iwata Momoka	NMB48 Team Kenkyusei
梅山恋和	Umeyama Cocona	NMB48 Team Kenkyusei
小嶋花梨	Kojima Karin	NMB48 Team Kenkyusei
清水里香	Shimizu Rika	NMB48 Team Kenkyusei
上西怜	Jonishi Rei	NMB48 Team Kenkyusei
中川美音	Nakagawa Mion	NMB48 Team Kenkyusei
水田詩織	Mizuta Shiori	NMB48 Team Kenkyusei
溝川実来	Mizokawa Mirai	NMB48 Team Kenkyusei
山田寿々	Yamada Suzu	NMB48 Team Kenkyusei
山本彩加	Yamamoto Ayaka	NMB48 Team Kenkyusei
秋吉優花	Akiyoshi Yuka	Team H
井上由莉耶	Inoue Yuriya	Team H
宇井真白	Ui Mashiro	Team H
上野遥	Ueno Haruka	Team H
岡本尚子	Okamoto Naoko	Team H
神志那結衣	Kojina Yui	Team H
兒玉遥	Kodama Haruka	Team H / AKB48 Team K 
駒田京伽	Komada Hiroka	Team H
坂口理子	Sakaguchi Riko	Team H
指原莉乃	Sashihara Rino	Team H
田島芽瑠	Tashima Meru	Team H
田中菜津美	Tanaka Natsumi	Team H
田中美久	Tanaka Miku	Team H
松岡菜摘	Matsuoka Natsumi	Team H
矢吹奈子	Yabuki Nako	Team H / AKB48 Team B 
山田麻莉奈	Yamada Marina	Team H
山本茉央	Yamamoto Mao	Team H
若田部遥	Wakatabe Haruka	Team H
今田美奈	Imada Mina	Team KIV
岩花詩乃	Iwahana Shino	Team KIV
植木南央	Ueki Nao	Team KIV
多田愛佳	Ota Aika	Team KIV
熊沢世莉奈	Kumazawa Serina	Team KIV
下野由貴	Shimono Yuki	Team KIV
田中優香	Tanaka Yuka	Team KIV
冨吉明日香	Tomiyoshi Asuka	Team KIV
朝長美桜	Tomonaga Mio	Team KIV / AKB48 Team 4 
深川舞子	Fukagawa Maiko	Team KIV
渕上舞	Fuchigami Mai	Team KIV
宮脇咲良	Miyawaki Sakura	Team KIV / AKB48 Team A 
村重杏奈	Murashige Anna	Team KIV
本村碧唯	Motomura Aoi	Team KIV
森保まどか	Moriyasu Madoka	Team KIV
荒巻美咲	Aramaki Misaki	Team TII
今村麻莉愛	Imamura Maria	Team TII
栗原紗英	Kurihara Sae	Team TII
坂本愛玲菜	Sakamoto Erena	Team TII
筒井莉子	Tsutsui Riko	Team TII
外薗葉月	Hokazono Hazuki	Team TII
松岡はな	Matsuoka Hana	Team TII
村川緋杏	Murakawa Bibian	Team TII
山内祐奈	Yamauchi Yuna	Team TII
山下エミリー	Yamashita Emiri	Team TII
運上弘菜	Unjo Hirona	研究生
小田彩加	Oda Ayaka	研究生
堺萌香	Sakai Moeka	研究生
清水梨央	Shimizu Rio	研究生
武田智加	Takeda Tomoka	研究生
地頭江音々	Jitoe Nene	研究生
月足天音	Tsukiashi Amane	研究生
豊永阿紀	Toyonaga Aki	研究生
松本日向	Matsumoto Hinata	研究生
宮崎想乃	Miyazaki Sono	研究生
Della Delila	Della Delila	JKT48 Team J
Dena Siti Rohyati	Dena Siti Rohyati	JKT48 Team J
Devi Kinal Putri	Devi Kinal Putri	JKT48 Team J
Dwi Putri Bonita	Dwi Putri Bonita	JKT48 Team J
Feni Fitriyanti	Feni Fitriyanti	JKT48 Team J
Gabriela Margareth Warouw	Gabriela Margareth Warouw	JKT48 Team J
Haruka Nakagawa	Haruka Nakagawa	JKT48 Team J
Jessica Vania	Jessica Vania	JKT48 Team J
Jessica Veranda	Jessica Veranda	JKT48 Team J
Melody Nurramdhani Laksani	Melody Nurramdhani Laksani	JKT48 Team J
Michelle Christo Kusnadi	Michelle Christo Kusnadi	JKT48 Team J
Nabilah Ratna Ayu Azalia	Nabilah Ratna Ayu Azalia	JKT48 Team J
Nadhifa Salsabila	Nadhifa Salsabila	JKT48 Team J
Priscillia Sari Dewi	Priscillia Sari Dewi	JKT48 Team J
Riskha Fairunissa	Riskha Fairunissa	JKT48 Team J
Saktia Oktapyani	Saktia Oktapyani	JKT48 Team J
Shania Junianatha	Shania Junianatha	JKT48 Team J
Sinka Juliani	Sinka Juliani	JKT48 Team J
Syahfira Angela Nurhaliza	Syahfira Angela Nurhaliza	JKT48 Team J
Thalia Ivanka Elizabeth	Thalia Ivanka Elizabeth	JKT48 Team J
Viviyona Apriani	Viviyona Apriani	JKT48 Team J
Yansen Indiani	Yansen Indiani	JKT48 Team J
Alicia Chanzia	Alicia Chanzia	JKT48 Team KIII
Amanda Dwi Arista	Amanda Dwi Arista	JKT48 Team KIII
Aninditha Rahma Cahyadi	Aninditha Rahma Cahyadi	JKT48 Team KIII
Ayana Shahab	Ayana Shahab	JKT48 Team KIII
Ayu Safira Oktaviani	Ayu Safira Oktaviani	JKT48 Team KIII
Beby Chaesara Anadila	Beby Chaesara Anadila	JKT48 Team KIII
Cindy Yuvia	Cindy Yuvia	JKT48 Team KIII
Fakhriyani Shafariyanti	Fakhriyani Shafariyanti	JKT48 Team KIII
Fransisca Saraswati Puspa Dewi	Fransisca Saraswati Puspa Dewi	JKT48 Team KIII
Frieska Anastasia Laksani	Frieska Anastasia Laksani	JKT48 Team KIII
Jennifer Rachel Natasya	Jennifer Rachel Natasya	JKT48 Team KIII
Lidya Maulida Djuhandar	Lidya Maulida Djuhandar	JKT48 Team KIII
Maria Genoveva Natalia Desy Purnamasari Gunawan	Maria Genoveva Natalia Desy Purnamasari Gunawan	JKT48 Team KIII
Nadila Cindi Wantari	Nadila Cindi Wantari	JKT48 Team KIII
Natalia	Natalia	JKT48 Team KIII
Ni Made Ayu Vania Aurellia	Ni Made Ayu Vania Aurellia	JKT48 Team KIII
Ratu Vienny Fitrilya	Ratu Vienny Fitrilya	JKT48 Team KIII
Rina Chikano	Rina Chikano	JKT48 Team KIII
Rona Anggreani	Rona Anggreani	JKT48 Team KIII
Shani Indira Natio	Shani Indira Natio	JKT48 Team KIII
Shania Gracia	Shania Gracia	JKT48 Team KIII
Shinta Naomi	Shinta Naomi	JKT48 Team KIII
Sonia Natalia	Sonia Natalia	JKT48 Team KIII
Stephanie Pricilla Indarto Putri	Stephanie Pricilla Indarto Putri	JKT48 Team KIII
Adhisty Zara	Adhisty Zara	JKT48 Team T
Adriani Elisabeth	Adriani Elisabeth	JKT48 Team T
Christi	Christi	JKT48 Team T
Cindy Hapsari Maharani Pujiantoro Putri	Cindy Hapsari Maharani Pujiantoro Putri	JKT48 Team T
Elizabeth Gloria Setiawan	Elizabeth Gloria Setiawan	JKT48 Team T
Eve Antoinette Ichwan	Eve Antoinette Ichwan	JKT48 Team T
Fidly Immanda Azzahra	Fidly Immanda Azzahra	JKT48 Team T
Jinan Safa Safira	Jinan Safa Safira	JKT48 Team T
Made Devi Ranita Ningtara	Made Devi Ranita Ningtara	JKT48 Team T
Melati Putri Rahel Sesilia	Melati Putri Rahel Sesilia	JKT48 Team T
Melody Nurramdhani Laksani	Melody Nurramdhani Laksani	JKT48 Team T
Nurhayati	Nurhayati	JKT48 Team T
Puti Nadhira Azalia	Puti Nadhira Azalia	JKT48 Team T
Regina Angelina	Regina Angelina	JKT48 Team T
Ruth Damayanti Sitanggang	Ruth Damayanti Sitanggang	JKT48 Team T
Sri Lintang 	Sri Lintang 	JKT48 Team T
Tan Zhi Hui Celine	Tan Zhi Hui Celine	JKT48 Team T
Violeta Burhan	Violeta Burhan	JKT48 Team T
Zahra Yuriva Dermawan	Zahra Yuriva Dermawan	JKT48 Team T
Chintya Hanindhitakirana Wirawan	Chintya Hanindhitakirana Wirawan	JKT48 Team kenkyusei
Citra Ayu Pranajaya Wibrado	Citra Ayu Pranajaya Wibrado	JKT48 Team kenkyusei
Diani Amalia Ramadhani	Diani Amalia Ramadhani	JKT48 Team kenkyusei
Gabryela Marcelina	Gabryela Marcelina	JKT48 Team kenkyusei
Hasyakyla Utami Kusumawardhani	Hasyakyla Utami Kusumawardhani	JKT48 Team kenkyusei
Sania Julia Montolalu	Sania Julia Montolalu	JKT48 Team kenkyusei
